(supertux-level
  (version 3)
  (name (_ "Level 24"))
  (author "SuperTux Player")
  (license "CC-BY-SA 4.0 International")
  (icon "")
  (icon-locked "")
  (sector
    (name "main")
    (gravity -1)
    (ambient-light
      (color 1 1 1)
    )
    (camera
      (name "Camera")
      (mode "normal")
    )
    (decal
      (z-pos -50)
      (sprite "/mods/v0.7.0/images/creatures/boss/monkey/boss.sprite")
      (x 2,208)
      (y 416)
    )
    (door
      (sprite "/mods/v0.7.0/images/objects/door/desdoor.sprite")
      (locked #f)
      (x 832)
      (y 480)
    )
    (igel
      (direction "left")
      (x 1,792)
      (y 544)
    )
    (mrtree
      (direction "left")
      (x 864)
      (y 480)
    )
    (mrtree
      (type "corrupted")
      (direction "left")
      (sprite "images/creatures/mr_tree/corrupted/haunted_tree.sprite")
      (x 992)
      (y 480)
    )
    (music
      (file "/music/misc/credits.music")
    )
    (scriptedobject
      (sprite "/images/creatures/penny/penny.sprite")
      (x 704)
      (y 512)
    )
    (snowball
      (direction "left")
      (x 992)
      (y 544)
    )
    (snowball
      (direction "left")
      (x 1,056)
      (y 544)
    )
    (snowball
      (direction "left")
      (x 1,088)
      (y 544)
    )
    (spawnpoint
      (name "main")
      (x 64)
      (y 480)
    )
    (tilemap
      (solid #f)
      (z-pos -100)
      (width 100)
      (height 35)
      (tiles
      0 0 0 0 0 0 0 0 0 0 0 0 0 0 0 0 0 0 0 0 0 0 0 0 0 0 0 0 0 0 0 0 0 0 0 0 0 0 0 0 0 0 0 0 0 0 0 0 0 0 0 0 0 0 0 0 0 0 0 0 0 0 0 0 0 0 0 0 0 0 0 0 0 0 0 0 0 0 0 0 0 0 0 0 0 0 0 0 0 0 0 0 0 0 0 0 0 0 0 0
      0 0 0 0 0 0 0 0 0 0 0 0 0 0 0 0 0 0 0 0 0 0 0 0 0 0 0 0 0 0 0 0 0 0 0 0 0 0 0 0 0 0 0 0 0 0 0 0 0 0 0 0 0 0 0 0 0 0 0 0 0 0 0 0 0 0 0 0 0 0 0 0 0 0 0 0 0 0 0 0 0 0 0 0 0 0 0 0 0 0 0 0 0 0 0 0 0 0 0 0
      0 0 0 0 0 0 0 0 0 0 0 0 0 0 0 0 0 0 0 0 0 0 0 0 0 0 0 0 0 0 0 0 0 0 0 0 0 0 0 0 0 0 0 0 0 0 0 0 0 0 0 0 0 0 0 0 0 0 0 0 0 0 0 0 0 0 0 0 0 0 0 0 0 0 0 0 0 0 0 0 0 0 0 0 0 0 0 0 0 0 0 0 0 0 0 0 0 0 0 0
      0 0 0 0 0 0 0 0 0 0 0 0 0 0 0 0 0 0 0 0 0 0 0 0 0 0 0 0 0 0 0 0 0 0 0 0 0 0 0 0 0 0 0 0 0 0 0 0 0 0 0 0 0 0 0 0 0 0 0 0 0 0 0 0 0 0 0 0 0 0 0 0 0 0 0 0 0 0 0 0 0 0 0 0 0 0 0 0 0 0 0 0 0 0 0 0 0 0 0 0
      0 0 0 0 0 0 0 0 0 0 0 0 0 0 0 0 0 0 0 0 0 0 0 0 0 0 0 0 0 0 0 0 0 0 0 0 0 0 0 0 0 0 0 0 0 0 0 0 0 0 0 0 0 0 0 0 0 0 0 0 0 0 0 0 0 0 0 0 0 0 0 0 0 0 0 0 0 0 0 0 0 0 0 0 0 0 0 0 0 0 0 0 0 0 0 0 0 0 0 0
      0 0 0 0 0 0 0 0 0 0 0 0 0 0 0 0 0 0 0 0 0 0 0 0 0 0 0 0 0 0 0 0 0 0 0 0 0 0 0 0 0 0 0 0 0 0 0 0 0 0 0 0 0 0 0 0 0 0 0 0 0 0 0 0 0 0 0 0 0 0 0 0 0 0 0 0 0 0 0 0 0 0 0 0 0 0 0 0 0 0 0 0 0 0 0 0 0 0 0 0
      0 0 0 0 0 0 0 0 0 0 0 0 0 0 0 0 0 0 0 0 0 0 0 0 0 0 0 0 0 0 0 0 0 0 0 0 0 0 0 0 0 0 0 0 0 0 0 0 0 0 0 0 0 0 0 0 0 0 0 0 0 0 0 0 0 0 0 0 0 0 0 0 0 0 0 0 0 0 0 0 0 0 0 0 0 0 0 0 0 0 0 0 0 0 0 0 0 0 0 0
      0 0 0 0 0 0 0 0 0 0 0 0 0 0 0 0 0 0 0 0 0 0 0 0 0 0 0 0 0 0 0 0 0 0 0 0 0 0 0 0 0 0 0 0 0 0 0 0 0 0 0 0 0 0 0 0 0 0 0 0 0 0 0 0 0 0 0 0 0 0 0 0 0 0 0 0 0 0 0 0 0 0 0 0 0 0 0 0 0 0 0 0 0 0 0 0 0 0 0 0
      0 0 0 0 0 0 0 0 0 0 0 0 0 0 0 0 0 0 0 0 0 0 0 0 0 0 0 0 0 0 0 0 0 0 0 0 0 0 0 0 0 0 0 0 0 0 0 0 0 0 0 0 0 0 0 0 0 0 0 0 0 0 0 0 0 0 0 0 0 0 0 0 0 0 0 0 0 0 0 0 0 0 0 0 0 0 0 0 0 0 0 0 0 0 0 0 0 0 0 0
      0 0 0 0 0 0 0 0 0 0 0 0 0 0 0 0 0 0 0 0 0 0 0 0 0 0 0 0 0 0 0 0 0 0 0 0 0 0 0 0 0 0 0 0 0 0 0 0 0 0 0 0 0 0 0 0 0 0 0 0 0 0 0 0 0 0 0 0 0 0 0 0 0 0 0 0 0 0 0 0 0 0 0 0 0 0 0 0 0 0 0 0 0 0 0 0 0 0 0 0
      0 0 0 0 0 0 0 0 0 0 0 0 0 0 0 0 0 0 0 0 0 0 0 0 0 0 0 0 0 0 0 0 0 0 0 0 0 0 0 0 0 0 0 0 0 0 0 0 0 0 0 0 0 0 0 0 0 0 0 0 0 0 0 0 0 0 0 0 0 0 0 0 0 0 0 0 0 0 0 0 0 0 0 0 0 0 0 0 0 0 0 0 0 0 0 0 0 0 0 0
      0 0 0 0 0 0 0 0 0 0 0 0 0 0 0 0 0 0 0 0 0 0 0 0 0 0 0 0 0 0 0 0 0 0 0 0 0 0 0 0 0 0 0 0 0 0 0 0 0 0 0 0 0 0 0 0 0 0 0 0 0 0 0 0 0 0 0 0 0 0 0 0 0 0 0 0 0 0 0 0 0 0 0 0 0 0 0 0 0 0 0 0 0 0 0 0 0 0 0 0
      0 0 0 0 0 0 0 0 0 0 0 0 0 0 0 0 0 0 0 0 0 0 0 0 0 0 0 0 0 0 0 0 0 0 0 0 0 0 0 0 0 0 0 0 0 0 0 0 0 0 0 0 0 0 0 0 0 0 0 0 0 0 0 0 0 0 0 0 0 0 0 0 0 0 0 0 0 0 0 0 0 0 0 0 0 0 0 0 0 0 0 0 0 0 0 0 0 0 0 0
      0 0 0 0 0 0 0 0 0 0 0 0 0 0 0 0 0 0 0 0 0 0 0 0 0 0 0 0 0 0 0 0 0 0 0 0 0 0 0 0 0 0 0 0 0 0 0 0 0 0 0 0 0 0 0 0 0 0 0 0 0 0 0 0 0 0 0 0 0 0 0 0 0 0 0 0 0 0 0 0 0 0 0 0 0 0 0 0 0 0 0 0 0 0 0 0 0 0 0 0
      0 0 0 0 0 0 0 0 0 0 0 0 0 0 0 0 0 0 0 0 0 0 0 0 0 0 0 0 0 0 0 0 0 0 0 0 0 0 0 0 0 0 0 0 0 0 0 0 0 0 0 0 0 0 0 0 0 0 0 0 0 0 0 0 0 0 0 0 0 0 0 0 0 0 0 0 0 0 0 0 0 0 0 0 0 0 0 0 0 0 0 0 0 0 0 0 0 0 0 0
      0 0 0 0 0 0 0 0 0 0 0 0 0 0 0 0 0 0 0 0 0 0 0 0 0 0 0 0 0 0 0 0 0 0 0 0 0 0 0 0 0 0 0 0 0 0 0 0 0 0 0 0 0 0 0 0 0 0 0 0 0 0 0 0 0 0 0 0 0 0 0 0 0 0 0 0 0 0 0 0 0 0 0 0 0 0 0 0 0 0 0 0 0 0 0 0 0 0 0 0
      0 0 0 0 0 0 0 0 0 0 0 0 0 0 0 0 0 0 0 0 0 0 0 0 0 0 0 0 0 0 0 0 0 0 0 0 0 0 0 0 0 0 0 0 0 0 0 0 0 0 0 0 0 0 0 0 0 0 0 0 0 0 0 0 0 0 0 0 0 0 0 0 0 0 0 0 0 0 0 0 0 0 0 0 0 0 0 0 0 0 0 0 0 0 0 0 0 0 0 0
      8 8 8 8 8 8 8 8 8 8 8 8 8 8 8 8 8 8 8 8 8 8 8 8 8 8 8 8 8 8 8 8 8 8 8 8 8 8 8 8 8 8 8 8 8 8 8 8 8 8 8 8 8 8 8 8 8 8 8 8 8 8 8 8 8 8 8 8 8 8 8 8 8 8 8 8 8 8 8 8 8 8 8 8 8 8 8 8 8 8 8 8 8 8 8 8 8 8 8 8
      14 14 14 14 14 14 3.990 14 14 14 14 3.989 14 14 14 14 14 3.990 14 14 3.990 14 14 14 3.990 14 14 14 14 14 14 14 14 3.988 14 3.990 14 3.989 14 3.988 14 14 14 14 14 14 14 14 14 14 14 14 3.988 14 14 14 14 3.989 14 14 14 14 3.989 14 14 14 14 14 14 14 14 14 14 14 14 14 14 14 14 14 14 14 14 14 14 3.990 14 3.990 14 14 14 14 3.989 3.989 14 3.988 3.989 14 14 14
      11 11 11 11 11 2.134 2.135 11 2.134 2.134 11 2.134 2.135 11 11 2.135 2.135 11 11 11 11 11 11 2.134 11 11 11 11 11 2.134 11 11 2.134 2.134 2.134 2.134 11 11 11 11 11 11 11 2.135 11 11 2.135 11 11 11 2.135 11 2.134 2.134 11 2.135 11 2.134 2.135 11 2.134 11 2.134 11 11 11 11 2.134 11 11 2.134 11 2.134 2.135 11 11 2.135 2.134 11 11 2.135 2.134 11 11 11 11 11 2.135 11 11 11 11 11 2.135 11 2.134 11 2.135 2.134 2.135
      11 11 2.134 11 2.134 2.134 2.135 11 11 11 11 11 11 11 11 11 11 11 11 11 2.135 11 2.135 11 11 11 11 11 11 11 11 11 2.134 11 11 2.135 11 11 2.135 11 2.134 11 2.135 2.134 2.134 2.135 11 2.135 2.134 2.135 11 11 11 2.135 2.134 11 2.135 11 2.135 11 2.135 11 11 2.134 2.135 2.135 11 11 11 11 2.134 2.135 11 2.135 2.134 11 11 2.134 11 2.134 11 2.134 11 2.135 2.134 11 19 2.135 11 2.135 2.134 2.135 11 2.135 11 11 11 11 11 11
      11 11 11 2.134 11 2.134 11 2.135 2.135 11 11 11 2.135 2.135 11 11 11 11 2.134 2.135 2.135 11 11 11 2.134 2.135 2.135 2.134 11 11 2.134 2.135 2.135 2.134 11 11 11 2.135 2.134 11 11 11 2.134 2.135 11 11 11 11 11 11 11 2.134 11 11 2.135 2.135 11 11 11 11 2.134 2.134 11 11 11 2.135 2.135 2.135 11 2.135 11 11 2.135 11 11 11 2.135 11 11 2.134 11 11 2.134 11 2.134 11 11 11 2.134 11 2.135 2.135 11 2.134 2.134 11 2.134 2.135 11 11
      11 2.135 11 11 11 2.134 11 11 2.134 11 11 2.134 2.134 2.135 2.134 11 2.135 11 11 2.134 2.135 2.134 11 11 11 2.134 2.135 11 11 2.134 11 2.135 11 11 2.135 11 11 11 2.134 11 11 11 2.134 11 11 2.134 11 2.134 2.134 2.135 11 11 2.134 11 11 2.135 2.135 11 11 2.135 2.135 11 2.134 2.134 11 11 11 2.134 11 11 11 2.134 11 2.134 11 11 11 11 11 11 11 2.134 2.135 11 11 11 2.134 2.134 2.134 11 2.134 11 2.134 11 11 11 2.135 11 11 11
      11 11 2.135 2.135 11 2.134 2.134 2.135 11 11 11 11 11 2.135 11 2.134 2.134 11 2.134 11 2.135 11 2.135 11 2.134 11 11 2.134 11 11 11 11 2.135 2.134 11 11 2.134 11 11 2.135 2.135 2.135 11 11 2.135 11 11 2.134 11 11 11 2.134 11 2.134 11 11 11 11 2.134 2.135 11 2.135 2.134 11 11 11 2.135 11 11 11 2.134 11 11 11 11 11 11 11 2.135 2.135 2.134 2.134 2.134 2.134 2.135 11 2.135 11 11 2.134 11 2.135 11 11 11 11 2.135 2.135 11 11
      11 11 11 2.134 11 2.135 2.135 11 11 11 2.135 2.134 11 11 11 11 2.134 2.134 11 11 11 2.134 2.135 2.134 11 2.134 2.134 2.134 11 2.135 11 2.134 2.135 11 11 11 11 2.134 2.135 11 11 11 2.134 11 11 2.135 11 11 11 11 11 11 2.134 11 2.134 11 2.134 11 2.134 11 2.134 2.134 11 11 11 2.135 11 11 2.135 11 2.134 2.135 2.135 2.134 11 11 2.135 11 11 2.134 11 11 11 2.135 2.135 11 2.134 11 11 11 11 11 11 11 11 11 2.134 11 2.135 2.134
      2.134 2.134 2.135 11 11 11 11 11 11 11 11 11 11 11 2.135 11 2.135 11 11 2.134 2.134 11 11 11 11 2.135 11 2.134 2.135 2.135 2.134 11 11 2.134 11 2.135 11 11 2.135 2.134 11 11 2.134 11 2.134 11 11 2.134 11 11 11 11 11 2.134 11 2.135 2.134 11 2.135 11 11 2.135 11 11 2.134 2.135 2.135 11 2.135 11 11 11 2.135 2.134 11 2.134 11 11 2.135 11 2.135 11 11 2.135 2.134 2.134 11 11 11 11 11 2.135 2.135 11 2.134 2.134 11 2.135 11 11
      2.134 2.135 11 11 2.135 11 2.134 2.134 2.135 2.134 2.134 11 11 2.134 2.134 11 11 2.134 11 2.135 11 11 11 11 11 11 11 11 2.134 11 11 11 2.134 2.134 2.134 2.134 2.135 2.135 11 11 2.135 11 11 2.135 11 11 2.135 2.135 11 11 11 2.134 11 11 2.135 2.134 11 11 2.134 2.135 11 2.134 2.134 11 11 11 11 11 2.134 2.134 11 11 2.134 11 11 2.134 2.135 11 11 11 2.135 11 2.134 11 11 11 11 11 11 2.135 11 11 11 11 2.135 2.135 11 11 11 11
      2.135 11 2.135 2.134 2.135 11 11 11 2.135 2.135 11 11 11 11 11 11 11 11 11 11 11 2.134 2.135 2.135 2.134 11 11 26 11 11 11 2.134 11 2.135 11 2.135 11 11 2.134 11 11 11 2.134 11 2.135 2.134 2.135 11 11 11 11 11 2.134 11 11 11 11 2.134 2.135 2.134 11 2.135 11 2.135 2.134 11 2.135 2.135 2.135 2.134 11 2.134 2.135 11 11 11 11 11 11 11 11 2.134 11 11 11 2.135 2.135 11 2.134 11 11 2.134 11 11 11 2.135 11 11 11 11
      2.135 11 11 11 2.135 2.134 2.134 11 2.135 11 2.135 2.135 11 2.134 11 11 11 11 11 2.135 11 11 2.134 11 11 11 2.134 11 2.134 2.135 11 11 11 11 11 11 11 11 2.134 2.135 11 2.135 2.134 2.134 2.135 11 11 11 11 11 11 2.134 11 2.134 11 2.134 11 2.135 2.134 11 11 2.134 2.135 2.135 2.134 2.135 11 2.135 2.134 11 11 2.134 2.134 2.134 11 11 11 11 2.135 2.135 2.134 2.135 11 11 2.135 11 11 11 2.135 11 11 2.134 11 11 2.135 2.134 2.135 2.134 2.135 2.134
      2.135 2.135 2.135 11 2.135 2.135 11 11 11 2.134 11 2.135 2.135 11 11 2.134 2.134 11 2.134 2.134 11 11 11 11 2.135 11 11 11 11 2.135 11 2.135 11 2.135 11 2.135 11 11 2.134 2.134 11 2.134 11 11 11 11 2.134 11 11 11 11 11 2.134 2.134 11 2.135 11 11 2.134 2.135 11 2.135 2.135 11 2.135 11 2.135 11 2.135 11 11 11 11 2.135 11 11 2.135 11 11 2.135 2.134 11 2.134 2.135 11 2.134 11 11 2.134 11 11 11 11 2.135 11 11 11 11 11 11
      11 11 11 11 11 11 2.135 2.135 11 11 11 11 11 2.135 11 11 11 11 11 11 11 11 19 2.134 2.134 11 11 11 2.134 2.135 2.135 2.135 2.135 2.135 2.135 2.135 2.135 11 11 2.134 11 2.135 2.134 2.134 11 2.134 2.134 2.135 11 11 11 11 11 2.135 2.135 11 11 11 11 11 11 11 11 2.134 2.134 2.134 11 11 2.134 2.134 2.134 11 2.135 11 11 11 2.135 11 2.135 11 11 2.135 2.135 2.135 11 2.134 11 11 11 2.135 2.134 2.135 11 11 2.134 11 19 11 11 11
      11 11 11 2.135 11 2.134 11 2.135 11 2.134 11 11 2.134 2.135 11 2.134 11 2.134 2.135 11 2.135 2.135 2.135 11 2.134 2.135 2.135 2.134 11 11 2.134 11 2.134 11 11 11 2.134 11 11 2.135 11 11 2.134 11 11 11 2.135 2.134 2.135 11 11 2.134 11 11 11 11 11 11 11 2.135 2.135 2.134 11 11 11 2.134 11 11 11 2.135 11 11 11 2.135 11 11 2.134 11 11 2.135 11 2.135 2.134 2.134 2.135 11 2.134 11 2.134 11 2.135 2.135 11 11 26 11 11 11 11 11
      11 2.134 2.134 2.134 11 11 11 2.135 2.135 11 11 11 11 2.134 2.134 11 11 11 11 2.134 11 2.135 11 11 11 2.134 11 11 11 2.134 2.134 2.134 19 11 11 11 2.134 2.135 11 11 11 2.135 2.135 11 2.134 11 11 11 2.134 2.135 11 11 2.135 2.134 11 2.135 11 11 2.135 11 2.135 11 11 11 2.135 11 11 11 2.135 11 2.135 11 11 2.134 2.135 2.135 11 11 11 2.134 11 2.134 11 11 11 11 2.135 2.134 2.134 11 2.134 2.134 11 11 11 11 11 2.135 11 2.135
      11 11 11 2.134 11 11 11 2.135 11 2.135 11 2.135 11 2.135 11 11 11 2.134 11 2.135 11 11 2.134 11 11 11 11 11 2.135 11 2.135 11 2.134 11 2.134 11 2.135 2.134 11 11 2.134 11 2.134 11 11 2.135 2.134 2.134 11 2.135 2.135 26 2.134 11 11 2.134 2.135 11 2.135 2.134 11 11 11 2.135 11 11 11 2.135 11 2.134 2.135 11 11 11 11 11 11 11 11 11 11 2.135 11 11 11 11 2.134 11 11 2.134 11 11 2.134 11 2.134 11 2.134 11 2.134 11
      11 11 2.135 11 2.134 11 2.134 2.135 2.134 2.134 11 11 2.135 2.135 2.134 2.135 2.135 11 11 11 11 11 11 11 11 11 2.135 11 11 11 11 11 11 11 11 11 11 2.134 11 2.134 11 11 11 11 2.134 2.134 11 2.134 2.134 11 2.135 11 2.135 11 2.135 11 2.135 11 11 2.135 11 11 2.134 11 11 2.135 11 11 11 11 11 11 11 11 2.135 2.134 11 11 11 11 11 2.135 11 2.135 2.134 2.135 11 2.134 2.134 2.135 11 11 2.135 2.134 2.135 2.134 2.135 2.134 2.135 2.134
      )
    )
    (tilemap
      (solid #f)
      (z-pos 100)
      (width 100)
      (height 35)
      (tiles
      0 0 0 0 0 0 0 0 0 0 0 0 0 0 0 0 0 0 0 0 0 0 0 0 0 0 0 0 0 0 0 0 0 0 0 0 0 0 0 0 0 0 0 0 0 0 0 0 0 0 0 0 0 0 0 0 0 0 0 0 0 0 0 0 0 0 0 0 0 0 0 0 0 0 0 0 0 0 0 0 0 0 0 0 0 0 0 0 0 0 0 0 0 0 0 0 0 0 0 0
      0 0 0 0 0 0 0 0 0 0 0 0 0 0 0 0 0 0 0 0 0 0 0 0 0 0 0 0 0 0 0 0 0 0 0 0 0 0 0 0 0 0 0 0 0 0 0 0 0 0 0 0 0 0 0 0 0 0 0 0 0 0 0 0 0 0 0 0 0 0 0 0 0 0 0 0 0 0 0 0 0 0 0 0 0 0 0 0 0 0 0 0 0 0 0 0 0 0 0 0
      0 0 0 0 0 0 0 0 0 0 0 0 0 0 0 0 0 0 0 0 0 0 0 0 0 0 0 0 0 0 0 0 0 0 0 0 0 0 0 0 0 0 0 0 0 0 0 0 0 0 0 0 0 0 0 0 0 0 0 0 0 0 0 0 0 0 0 0 0 0 0 0 0 0 0 0 0 0 0 0 0 0 0 0 0 0 0 0 0 0 0 0 0 0 0 0 0 0 0 0
      0 0 0 0 0 0 0 0 0 0 0 0 0 0 0 0 0 0 0 0 0 0 0 0 0 0 0 0 0 0 0 0 0 0 0 0 0 0 0 0 0 0 0 0 0 0 0 0 0 0 0 0 0 0 0 0 0 0 0 0 0 0 0 0 0 0 0 0 0 0 0 0 0 0 0 0 0 0 0 0 0 0 0 0 0 0 0 0 0 0 0 0 0 0 0 0 0 0 0 0
      0 0 0 0 0 0 0 0 0 0 0 0 0 0 0 0 0 0 0 0 0 0 0 0 0 0 0 0 0 0 0 0 0 0 0 0 0 0 0 0 0 0 0 0 0 0 0 0 0 0 0 0 0 0 0 0 0 0 0 0 0 0 0 0 0 0 0 0 0 0 0 0 0 0 0 0 0 0 0 0 0 0 0 0 0 0 0 0 0 0 0 0 0 0 0 0 0 0 0 0
      0 0 0 0 0 0 0 0 0 0 0 0 0 0 0 0 0 0 0 0 0 0 0 0 0 0 0 0 0 0 0 0 0 0 0 0 0 0 0 0 0 0 0 0 0 0 0 0 0 0 0 0 0 0 0 0 0 0 0 0 0 0 0 0 0 0 0 0 0 0 0 0 0 0 0 0 0 0 0 0 0 0 0 0 0 0 0 0 0 0 0 0 0 0 0 0 0 0 0 0
      0 0 0 0 0 0 0 0 0 0 0 0 0 0 0 0 0 0 0 0 0 0 0 0 0 0 0 0 0 0 0 0 0 0 0 0 0 0 0 0 0 0 0 0 0 0 0 0 0 0 0 0 0 0 0 0 0 0 0 0 0 0 0 0 0 0 0 0 0 0 0 0 0 0 0 0 0 0 0 0 0 0 0 0 0 0 0 0 0 0 0 0 0 0 0 0 0 0 0 0
      0 0 0 0 0 0 0 0 0 0 0 0 0 0 0 0 0 0 0 0 0 0 0 0 0 0 0 0 0 0 0 0 0 0 0 0 0 0 0 0 0 0 0 0 0 0 0 0 0 0 0 0 0 0 0 0 0 0 0 0 0 0 0 0 0 0 0 0 0 0 0 0 0 0 0 0 0 0 0 0 0 0 0 0 0 0 0 0 0 0 0 0 0 0 0 0 0 0 0 0
      0 0 0 0 0 0 0 0 0 0 0 0 0 0 0 0 0 0 0 0 0 0 0 0 0 0 0 0 0 0 0 0 0 0 0 0 0 0 0 0 0 0 0 0 0 0 0 0 0 0 0 0 0 0 0 0 0 0 0 0 0 0 0 0 0 0 0 0 0 0 0 0 0 0 0 0 0 0 0 0 0 0 0 0 0 0 0 0 0 0 0 0 0 0 0 0 0 0 0 0
      0 0 0 0 0 0 0 0 0 0 0 0 0 0 0 0 0 0 0 0 0 0 0 0 0 0 0 0 0 0 0 0 0 0 0 0 0 0 0 0 0 0 0 0 0 0 0 0 0 0 0 0 0 0 0 0 0 0 0 0 0 0 0 0 0 0 0 0 0 0 0 0 0 0 0 0 0 0 0 0 0 0 0 0 0 0 0 0 0 0 0 0 0 0 0 0 0 0 0 0
      0 0 0 0 0 0 0 0 0 0 0 0 0 0 0 0 0 0 0 0 0 0 0 0 0 0 0 0 0 0 0 0 0 0 0 0 0 0 0 0 0 0 0 0 0 0 0 0 0 0 0 0 0 0 0 0 0 0 0 0 0 0 0 0 0 0 0 0 0 0 0 0 0 0 0 0 0 0 0 0 0 0 0 0 0 0 0 0 0 0 0 0 0 0 0 0 0 0 0 0
      0 0 0 0 0 0 0 0 0 0 0 0 0 0 0 0 0 0 0 0 0 0 0 0 0 0 0 0 0 0 0 0 0 0 0 0 0 0 0 0 0 0 0 0 0 0 0 0 0 0 0 0 0 0 0 0 0 0 0 0 0 0 0 0 0 0 0 0 0 0 0 0 0 0 0 0 0 0 0 0 0 0 0 0 0 0 0 0 0 0 0 0 0 0 0 0 0 0 0 0
      0 0 0 0 0 0 0 0 0 0 0 0 0 0 0 0 0 0 0 0 0 0 0 0 0 0 0 0 0 0 0 0 0 0 0 0 0 0 0 0 0 0 0 0 0 0 0 0 0 0 0 0 0 0 0 0 0 0 0 0 0 0 0 0 0 0 0 0 0 0 0 0 0 0 0 0 0 0 0 0 0 0 0 0 0 0 0 0 0 0 0 0 0 0 0 0 0 0 0 0
      0 0 0 0 0 0 0 0 0 0 0 0 0 0 0 0 0 0 0 0 0 0 0 0 0 0 0 0 0 0 0 0 0 0 0 0 0 0 0 0 0 0 0 0 0 0 0 0 0 0 0 0 0 0 0 0 0 0 0 0 0 0 0 0 0 0 0 0 0 0 0 0 0 0 0 0 0 0 0 0 0 0 0 0 0 0 0 0 0 0 0 0 0 0 0 0 0 0 0 0
      0 0 0 0 0 0 0 0 0 0 0 0 0 0 0 0 0 0 0 0 0 0 0 0 0 0 0 0 0 0 0 0 0 0 0 0 0 0 0 0 0 0 0 0 0 0 0 0 0 0 0 0 0 0 0 0 0 0 0 0 0 0 0 0 0 0 0 0 0 0 0 0 0 0 0 0 0 0 0 0 0 0 0 0 0 0 0 0 0 0 0 0 0 0 0 0 0 0 0 0
      0 0 0 0 0 0 0 0 0 0 0 0 0 0 0 0 0 0 0 0 0 0 0 0 0 0 0 0 0 0 0 0 0 0 0 0 0 0 0 0 0 0 0 0 0 0 0 0 0 0 0 0 0 0 0 0 0 0 0 0 0 0 0 0 0 0 0 0 0 0 0 0 0 0 0 0 0 0 0 0 0 0 0 0 0 0 0 0 0 0 0 0 0 0 0 0 0 0 0 0
      0 0 0 0 0 0 0 0 0 0 0 0 0 0 0 0 0 0 0 0 0 0 0 0 0 0 0 0 0 0 0 0 0 0 0 0 0 0 0 0 0 0 0 0 0 0 0 0 0 0 0 0 0 0 0 0 0 0 0 0 0 0 0 0 0 0 0 0 0 0 0 0 0 0 0 0 0 0 0 0 0 0 0 0 0 0 0 0 0 0 0 0 0 0 0 0 0 0 0 0
      0 0 0 0 0 0 0 0 0 0 0 0 0 0 0 0 0 0 0 0 0 0 0 0 0 0 0 0 0 0 0 0 0 0 0 0 0 0 0 0 0 0 0 0 0 0 0 0 0 0 0 0 0 0 0 0 0 0 0 0 0 0 0 0 0 0 0 0 0 0 0 0 0 0 0 0 0 0 0 0 0 0 0 0 0 0 0 0 0 0 0 0 0 0 0 0 0 0 0 0
      0 0 0 0 0 0 0 0 0 0 0 0 0 0 0 0 0 0 0 0 0 0 0 0 0 0 0 0 0 0 0 0 0 0 0 0 0 0 0 0 0 0 0 0 0 0 0 0 0 0 0 0 0 0 0 0 0 0 0 0 0 0 0 0 0 0 0 0 0 0 0 0 0 0 0 0 0 0 0 0 0 0 0 0 0 0 0 0 0 0 0 0 0 0 0 0 0 0 0 0
      0 0 0 0 0 0 0 0 0 0 0 0 0 0 0 0 0 0 0 0 0 0 0 0 0 0 0 0 0 0 0 0 0 0 0 0 0 0 0 0 0 0 0 0 0 0 0 0 0 0 0 0 0 0 0 0 0 0 0 0 0 0 0 0 0 0 0 0 0 0 0 0 0 0 0 0 0 0 0 0 0 0 0 0 0 0 0 0 0 0 0 0 0 0 0 0 0 0 0 0
      0 0 0 0 0 0 0 0 0 0 0 0 0 0 0 0 0 0 0 0 0 0 0 0 0 0 0 0 0 0 0 0 0 0 0 0 0 0 0 0 0 0 0 0 0 0 0 0 0 0 0 0 0 0 0 0 0 0 0 0 0 0 0 0 0 0 0 0 0 0 0 0 0 0 0 0 0 0 0 0 0 0 0 0 0 0 0 0 0 0 0 0 0 0 0 0 0 0 0 0
      0 0 0 0 0 0 0 0 0 0 0 0 0 0 0 0 0 0 0 0 0 0 0 0 0 0 0 0 0 0 0 0 0 0 0 0 0 0 0 0 0 0 0 0 0 0 0 0 0 0 0 0 0 0 0 0 0 0 0 0 0 0 0 0 0 0 0 0 0 0 0 0 0 0 0 0 0 0 0 0 0 0 0 0 0 0 0 0 0 0 0 0 0 0 0 0 0 0 0 0
      0 0 0 0 0 0 0 0 0 0 0 0 0 0 0 0 0 0 0 0 0 0 0 0 0 0 0 0 0 0 0 0 0 0 0 0 0 0 0 0 0 0 0 0 0 0 0 0 0 0 0 0 0 0 0 0 0 0 0 0 0 0 0 0 0 0 0 0 0 0 0 0 0 0 0 0 0 0 0 0 0 0 0 0 0 0 0 0 0 0 0 0 0 0 0 0 0 0 0 0
      0 0 0 0 0 0 0 0 0 0 0 0 0 0 0 0 0 0 0 0 0 0 0 0 0 0 0 0 0 0 0 0 0 0 0 0 0 0 0 0 0 0 0 0 0 0 0 0 0 0 0 0 0 0 0 0 0 0 0 0 0 0 0 0 0 0 0 0 0 0 0 0 0 0 0 0 0 0 0 0 0 0 0 0 0 0 0 0 0 0 0 0 0 0 0 0 0 0 0 0
      0 0 0 0 0 0 0 0 0 0 0 0 0 0 0 0 0 0 0 0 0 0 0 0 0 0 0 0 0 0 0 0 0 0 0 0 0 0 0 0 0 0 0 0 0 0 0 0 0 0 0 0 0 0 0 0 0 0 0 0 0 0 0 0 0 0 0 0 0 0 0 0 0 0 0 0 0 0 0 0 0 0 0 0 0 0 0 0 0 0 0 0 0 0 0 0 0 0 0 0
      0 0 0 0 0 0 0 0 0 0 0 0 0 0 0 0 0 0 0 0 0 0 0 0 0 0 0 0 0 0 0 0 0 0 0 0 0 0 0 0 0 0 0 0 0 0 0 0 0 0 0 0 0 0 0 0 0 0 0 0 0 0 0 0 0 0 0 0 0 0 0 0 0 0 0 0 0 0 0 0 0 0 0 0 0 0 0 0 0 0 0 0 0 0 0 0 0 0 0 0
      0 0 0 0 0 0 0 0 0 0 0 0 0 0 0 0 0 0 0 0 0 0 0 0 0 0 0 0 0 0 0 0 0 0 0 0 0 0 0 0 0 0 0 0 0 0 0 0 0 0 0 0 0 0 0 0 0 0 0 0 0 0 0 0 0 0 0 0 0 0 0 0 0 0 0 0 0 0 0 0 0 0 0 0 0 0 0 0 0 0 0 0 0 0 0 0 0 0 0 0
      0 0 0 0 0 0 0 0 0 0 0 0 0 0 0 0 0 0 0 0 0 0 0 0 0 0 0 0 0 0 0 0 0 0 0 0 0 0 0 0 0 0 0 0 0 0 0 0 0 0 0 0 0 0 0 0 0 0 0 0 0 0 0 0 0 0 0 0 0 0 0 0 0 0 0 0 0 0 0 0 0 0 0 0 0 0 0 0 0 0 0 0 0 0 0 0 0 0 0 0
      0 0 0 0 0 0 0 0 0 0 0 0 0 0 0 0 0 0 0 0 0 0 0 0 0 0 0 0 0 0 0 0 0 0 0 0 0 0 0 0 0 0 0 0 0 0 0 0 0 0 0 0 0 0 0 0 0 0 0 0 0 0 0 0 0 0 0 0 0 0 0 0 0 0 0 0 0 0 0 0 0 0 0 0 0 0 0 0 0 0 0 0 0 0 0 0 0 0 0 0
      0 0 0 0 0 0 0 0 0 0 0 0 0 0 0 0 0 0 0 0 0 0 0 0 0 0 0 0 0 0 0 0 0 0 0 0 0 0 0 0 0 0 0 0 0 0 0 0 0 0 0 0 0 0 0 0 0 0 0 0 0 0 0 0 0 0 0 0 0 0 0 0 0 0 0 0 0 0 0 0 0 0 0 0 0 0 0 0 0 0 0 0 0 0 0 0 0 0 0 0
      0 0 0 0 0 0 0 0 0 0 0 0 0 0 0 0 0 0 0 0 0 0 0 0 0 0 0 0 0 0 0 0 0 0 0 0 0 0 0 0 0 0 0 0 0 0 0 0 0 0 0 0 0 0 0 0 0 0 0 0 0 0 0 0 0 0 0 0 0 0 0 0 0 0 0 0 0 0 0 0 0 0 0 0 0 0 0 0 0 0 0 0 0 0 0 0 0 0 0 0
      0 0 0 0 0 0 0 0 0 0 0 0 0 0 0 0 0 0 0 0 0 0 0 0 0 0 0 0 0 0 0 0 0 0 0 0 0 0 0 0 0 0 0 0 0 0 0 0 0 0 0 0 0 0 0 0 0 0 0 0 0 0 0 0 0 0 0 0 0 0 0 0 0 0 0 0 0 0 0 0 0 0 0 0 0 0 0 0 0 0 0 0 0 0 0 0 0 0 0 0
      0 0 0 0 0 0 0 0 0 0 0 0 0 0 0 0 0 0 0 0 0 0 0 0 0 0 0 0 0 0 0 0 0 0 0 0 0 0 0 0 0 0 0 0 0 0 0 0 0 0 0 0 0 0 0 0 0 0 0 0 0 0 0 0 0 0 0 0 0 0 0 0 0 0 0 0 0 0 0 0 0 0 0 0 0 0 0 0 0 0 0 0 0 0 0 0 0 0 0 0
      0 0 0 0 0 0 0 0 0 0 0 0 0 0 0 0 0 0 0 0 0 0 0 0 0 0 0 0 0 0 0 0 0 0 0 0 0 0 0 0 0 0 0 0 0 0 0 0 0 0 0 0 0 0 0 0 0 0 0 0 0 0 0 0 0 0 0 0 0 0 0 0 0 0 0 0 0 0 0 0 0 0 0 0 0 0 0 0 0 0 0 0 0 0 0 0 0 0 0 0
      0 0 0 0 0 0 0 0 0 0 0 0 0 0 0 0 0 0 0 0 0 0 0 0 0 0 0 0 0 0 0 0 0 0 0 0 0 0 0 0 0 0 0 0 0 0 0 0 0 0 0 0 0 0 0 0 0 0 0 0 0 0 0 0 0 0 0 0 0 0 0 0 0 0 0 0 0 0 0 0 0 0 0 0 0 0 0 0 0 0 0 0 0 0 0 0 0 0 0 0
      )
    )
    (zeekling
      (direction "left")
      (x 1,888)
      (y 256)
    )
  )
)
